w-,w-,w-,w-,w-,w-,w-,w-,w-,w-,w-,w-,w-,w-,w-,w-
w-,--,--,--,--,--,--,--,--,--,--,--,--,--,--,w-
w-,--,--,--,--,--,--,--,--,--,--,--,--,--,--,w-
w-,--,--,--,--,--,--,--,--,--,--,--,--,--,--,w-
w-,--,--,--,--,--,--,--,--,--,--,--,--,--,--,w-
w-,--,--,--,--,--,--,--,--,--,--,--,--,--,--,w-
w-,--,--,--,--,--,--,--,--,--,--,--,--,--,--,w-
w-,--,--,--,--,--,--,--,--,--,--,--,--,--,--,w-
w-,--,--,--,--,--,--,--,--,--,--,--,--,--,--,w-
w-,--,--,--,--,--,--,--,--,--,--,--,--,--,--,w-
w-,--,--,--,--,--,--,--,--,--,--,--,--,--,--,w-
w-,--,--,r-,k-,--,b-,--,c0,--,--,--,--,--,--,w-
w-,w-,w-,w-,w-,w-,w-,w-,w-,w-,w-,w-,w-,w-,w-,w-
w-,w-,w-,w-,w-,w-,w-,w-,w-,w-,w-,w-,w-,w-,w-,w-
w-,w-,w-,w-,w-,w-,w-,w-,w-,w-,w-,w-,w-,w-,w-,w-
w-,w-,w-,w-,w-,w-,w-,w-,w-,w-,w-,w-,w-,w-,w-,w-
